27,48,40,40
111111111111111111111111111111111111111111111111
1----------------------------------------------1
1----------------------------------------------1
1----------------------------------------------1
1--------------------------------------------F-1
1---------------------------------------11111111
1--------------------------------------111111111
1----------------------------------------------1
1----------------------------------------------1
1-----111111XXXXXX111XXXXXX111XXXXXX11111------1
1-----11111111111111111111111111111111111------1
1----------------------------------------------1
111--------------------------------------------1
111--------------------------------------------1
111111111111XXXXXXX11111111XXXXXXX11111111-----1
111111111111111111111111111111111111111111-----1
1----------------------------------------------1
1--------------------------------------------111
1--------------------------------------------111
1-----------1111111111111XXXXXXX1111111111111111
1-----------111111111111111111111111111111111111
1----------------------------------------------1
11111111---------------------------------------1
11111111---------------------------------------1
1-----11----11---------------------------------1
1-----11----11------------------------------P--1
111111111111111111111111111111111111111111111111
0