27,48,40,40
111111111111111111111111111111111111111111111111
1----------------------------------------------1
1----------------------------------------------1
1-------11XX11XX11XX11XX11XX11XX11XX11---------1
1-------111111111111111111111111111111---11----1
1-------11-------------------------------------1
1-------11-------------------------------------1
1-------11-----------------------------------111
1-------11----11111XXXXX11111XXXXX11111XXXXX1111
1-------11----1111111111111111111111111111111111
1-------11-------------------------------------1
1-------1111-----------------------------------1
1-------1111-----------------------------------1
1-------111111111111111111111111111------------1
1-------111111111111111111111111111------------1
1---F---11---------------------------11--------1
1111111111---------------------------11--------1
1111111111-------------------------------11----1
1----------------------------------------11----1
1----------------------------------------------1
1--------------------------------------------111
1--------------------------------------------111
1-----1111XXXXXXX111XXXXXXX111XXXXXXX11111111111
1-----111111111111111111111111111111111111111111
111--------------------------------------------1
111-----------------------------------------P--1
111111111111111111111111111111111111111111111111
0