27,48,40,40
111111111111111111111111111111111111111111111111
1----------------------------------------------1
1-------------F--------------------------------1
1-----------1111111111111111111111-------------1
1-----------1111111111111111111111-------------1
1-----------1111111111111111111111-------------1
1---------------------------------------11111111
1---------------------------------------11111111
1----------------------------------------------1
1-----------1111111111111111111111-------------1
1-----------1111111111111111111111-------------1
1----------------------------------------------1
11111111---------------------------------------1
11111111---------------------------------------1
1----------------------------------------------1
1-----------1111111111111111111111-------------1
1-----------1111111111111111111111-------------1
1----------------------------------------------1
1----------------------------------------1111111
1----------------------------------------1111111
1----------------------------------------------1
1-----------1111111111111111111111-------------1
1-----------1111111111111111111111-------------1
1----------------------------------------------1
11111111---------------------------------------1
11111111------------------------------------P--1
111111111111111111111111111111111111111111111111
5
WireSource,5,46
DoorSegment,1,30,0
DoorSegment,2,30,1
DoorSegment,6,30,0
PlugDoorController,8,29,2,3