27,48,40,40
111111111111111111111111111111111111111111111111
1----------------------------------------------1
1----------------------------------------------1
1----------------------------------------------1
1----------------------------------------------1
1--------------------------------------------F-1
1---------------------------------------11111111
1---------------------------------------11111111
1-------------------------------11-------------1
1---------------------11-----------------------1
1-----------11--------11-----------------------1
1----------------------------------------------1
11111111---------------------------------------1
11111111---------------------------------------1
1----------------------------------------------1
1-----------11---------------------------------1
1-----------11--------11--------11-------------1
1----------------------------------------------1
1---------------------------------------11111111
1---------------------------------------11111111
1----------------------------------------------1
1-----------11------------------11-------------1
1-----------11------------------11-------------1
1----------------------------------------------1
1-----11---------------------------------------1
1-----11------------------------------------P--1
111111111111111111111111111111111111111111111111
3
DoorSegment,21,23,1,1
DoorSegment,21,22,1,1
PlugDoorController,25,4,0,1