27,48,40,40
111111111111111111111111111111111111111111111111
1----------------------------------------------1
1----------------------------------------------1
1----------------------------------------------1
1----------------------------------------------1
1---------------------------------------11111111
1---------------------------------------11111111
1----------------------------------------------1
1----------------------------------------------1
1-----111111XXXXXX111XXXXXX111XXXXXX11111------1
1-----11111111111111111111111111111111111------1
1----------------------------------------------1
111--------------------------------------------1
111--------------------------------------------1
111111111111XXXXXXX11111111XXXXXXX11111111-----1
111111111111111111111111111111111111111111-----1
1----------------------------------------------1
1--------------------------------------------111
1--------------------------------------------111
1-----------1111111111111XXXXXXX1111111111111111
1-----------111111111111111111111111111111111111
1----------------------------------------------1
11111111---------------------------------------1
11111111---------------------------------------1
1-----------11---------------------------------1
1-F---------11------------------------------P--1
111111111111111111111111111111111111111111111111
6
DoorSegment,24,7,0,0
DoorSegment,25,7,0,0
DoorSegment,16,31,1,1
DoorSegment,6,39,1,1
PlugDoorController,4,45,0,0,1,2
PlugDoorController,11,1,1,3