27,48,40,40
111111111111111111111111111111111111111111111111
1----------------------------------------------1
1----------------------------------------------1
1-----------1111111111111111111111-------------1
1-----------1111111111111111111111-------------1
1----------------------------------------------1
1---------------------------------------11111111
1---------------------------------------11111111
1----------------------------------------------1
1-----------1111111111111111111111-------------1
1-----------1111111111111111111111-------------1
1----------------------------------------------1
11111111---------------------------------------1
11111111---------------------------------------1
1----------------------------------------------1
1-----------1111111111111111111111-------------1
1-----------1111111111111111111111-------------1
1----------------------------------------------1
1---------------------------------------11111111
1---------------------------------------11111111
1----------------------------------------------1
1-----------1111111111111111111111-------------1
1-----------1111111111111111111111-------------1
1----------------------------------------------1
11111111---------------------------------------1
11111111---------------------------------------1
111111111111111111111111111111111111111111111111