27,48,40,40
111111111111111111111111111111111111111111111111
1--------------11------------------------------1
1--------------11------------------------------1
1-----1111-----11------------------------------1
1-----1111-----11------------------------------1
1-------11-----11-----------------------11111111
111-----11-----11-----------------------11111111
111-----11-----11--------1111XXXX1111----------1
1-------11-----11--------111111111111----------1
1-----1111-----11------------------------------1
1-----1111-----11----11------------------------1
1-------11-----11----11------------------------1
111-----11-----11------------------------------1
111-----11-----1111----------------------------1
1-------11-----1111----------------------------1
1-----1111-----1111111XX11XX11XX11111----------1
1-----1111-----1111111111111111111111----------1
1-------11-----11-----------------------11-----1
111-----11-----11-----------------------11-----1
111-----11-------------------------------------1
1-------11-----------------------------------111
1-----1111-----------------------------------111
1-----111111111111XXXXXXX111XXXXXXX1111111111111
1-------1111111111111111111111111111111111111111
111--------------------------------------------1
111--------------------------------------------1
111111111111111111111111111111111111111111111111
0