27,48,40,40
111111111111111111111111111111111111111111111111
1--------------11------------------------------1
1--------------11------------------------------1
1-----1111-----11------------------------------1
1-------11-----11----------------------------F-1
1-------11-----11-----------------------11111111
111-----11-----11-----------------------11111111
1-------11-----11--------1111XXXX1111----------1
1-------11-----11--------111111111111----------1
1-----1111-----11------------------------------1
1-------11-----11----11------------------------1
1-------11-----11----11------------------------1
111-----11-----11------------------------------1
1-------11-----1111----------------------------1
1-------11-----1111----------------------------1
1-----1111-----1111111XX11XX11XX11111----------1
1-------11-----1111111111111111111111----------1
1-------11-----11-----------------------11-----1
111-----11-----11-----------------------11-----1
1-------11-------------------------------------1
1-------11-----------------------------------111
1-----1111-----------------------------------111
1-------11--111111XXXXXXX111XXXXXXX1111111111111
1-------11--111111111111111111111111111111111111
111-----111------------------------------------1
111-----------------------------------------P--1
111111111111111111111111111111111111111111111111
25
DoorSegment,21,6,1,1
DoorSegment,21,7,1,1
DoorSegment,18,1,0,1
DoorSegment,18,2,0,1
DoorSegment,15,6,1,1
DoorSegment,15,7,1,1
DoorSegment,12,1,0,1
DoorSegment,12,2,0,1
DoorSegment,9,6,1,1
DoorSegment,9,7,1,1
DoorSegment,6,1,0,1
DoorSegment,6,2,0,1
DoorSegment,3,6,1,1
DoorSegment,3,7,1,1
DoorSegment,19,15,0,0
DoorSegment,20,15,0,0
DoorSegment,21,15,0,0
PlugDoorController,23,2,0,0,1,2,3,4,5,6,7,8,9,10,11,12,13
PlugDoorController,18,4,0,0,1,2,3,4,5,6,7,8,9,10,11,12,13
PlugDoorController,15,4,0,0,1,2,3,4,5,6,7,8,9,10,11,12,13
PlugDoorController,12,4,0,0,1,2,3,4,5,6,7,8,9,10,11,12,13
PlugDoorController,9,4,0,0,1,2,3,4,5,6,7,8,9,10,11,12,13
PlugDoorController,6,4,0,0,1,2,3,4,5,6,7,8,9,10,11,12,13
PlugDoorController,3,4,0,0,1,2,3,4,5,6,7,8,9,10,11,12,13
PlugDoorController,2,8,1,14,15,16