27,48,40,40
111111111111111111111111111111111111111111111111
1----------------------------------------------1
1--F-------------------------------------------1
1111111111111111111111111111111111-------------1
1111111111111111111111111111111111-------------1
1----------------------------------------------1
1---------------------------------------11111111
1---------------------------------------11111111
1----------------------------------------------1
1-----------11111111XXXXXX11111111-------------1
1-----------1111111111111111111111-------------1
1----------------------------------------------1
11111111---------------------------------------1
11111111---------------------------------------1
1----------------------------------------------1
1-----------11111111XXXXXX11111111-------------1
1-----------1111111111111111111111-------------1
1----------------------------------------------1
1---------------------------------------11111111
1---------------------------------------11111111
1----------------------------------------------1
1-----------11111111XXXXXX11111111-------------1
1-----------1111111111111111111111-------------1
1----------------------------------------------1
11111111---------------------------------------1
11111111------------------------------------P--1
111111111111111111111111111111111111111111111111
8
DoorSegment,1,30,0,0
DoorSegment,2,30,0,0
DoorSegment,17,12,0,0
DoorSegment,18,12,0,0
DoorSegment,19,12,0,0
DoorSegment,20,12,0,0
PlugDoorController,8,29,1,0,1
PlugDoorController,23,4,2,2,3,4,5