27,48,40,40
111111111111111111111111111111111111111111111111
1----------------------------------------------1
1--1---111-1-1-111----------1---1-111-111-111--1
1--1----1--1-1-1------------1---1--1----1-1----1
1--1----1--1-1-11-----------1---1--1--1-1-11---1
1--1----1--1-1-1------------1-1-1--1--11--1----1
1--1----1--111-1------------1-1-1--1--1-1-1----1
1--111-111--1--111----------11111-111-1-1-111--1
1----------------------------------------------1
1----------------------------------------------1
1----------------------------------------------1
1----------------------------------------------1
1----------------------------------------------1
1----------------------------------------------1
1----------------------------------------------1
1----------------------------------------------1
1----------------------------------------------1
1----------------------------------------------1
1----------------------------------------------1
1----------------------------------------------1
1----------------------------------------------1
1----------------------------------------------1
1----------------------------------------------1
1----------------------------------------------1
1----------------------------------------------1
1----------------------------------------------1
111111111111111111111111111111111111111111111111
0