27,48,40,40
000000000000000000000000000000000000000000000000
0----------------------------------------------0
0---000-000-000-000-----0---000-0-0-000-0------0
0----0--0---0----0------0---0---0-0-0---0------0
0----0--00--000--0------0---00--0-0-00--0------0
0----0--0-----0--0------0---0---000-0---0------0
0----0--000-000--0------000-000--0--000-000----0
0----------------------------------------------0
0----------------------------------------------0
0----------------------------------------------0
0----------------------------------------------0
0----------------------------------------------0
0----------------------------------------------0
0----------------------------------------------0
0----------------------------------------------0
0----------------------------------------------0
0----------------------------------------------0
0----------------------------------------------0
0----------------------------------------------0
0----------------------------------------------0
0----------------------------------------------0
0----------------------------------------------0
0----------------------------------------------0
0----------------------------------------------0
0----------------------------------------------0
0----------------------------------------------0
000000000000000000000000000000000000000000000000