27,48,40,40
111111111111111111111111111111111111111111111111
100000000000000000000000000000000000000000000001
100100011101010111000000000010001011101110111001
100100001001010100000000000010001001000010100001
100100001001010110000000000010001001001010110001
100100001001010100000000000010101001001100100001
100100001001110100000000000010101001001010100001
100111011100100111000000000011111011101010111001
100000000000000000000000000000000000000000000001
100000000000000000000000000000000000000000000001
100000000000000000000000000000000000000000000001
100000000000000000000000000000000000000000000001
100000000000000000000000000000000000000000000001
100000000000000000000000000000000000000000000001
100000000000000000000000000000000000000000000001
100000000000000000000000000000000000000000000001
100000000000000000000000000000000000000000000001
100000000000000000000000000000000000000000000001
100001110000000000000000000000000000011100000001
100011111000000000000000000000000000011100000001
100001110000000000000000000000000000011100000001
100000000000000011111000000000000000001000000001
100000000000000011111000000000000000011100000001
100000000000000011111000000000000000011100000001
100000000000000000000000000000000000011100000001
100000000000000000000000000000000000000000000001
111111111111111111111111111111111111111111111111